Total de bases com variações: 1157
Η: Η, Ἡ, Ἢ
Ο: Ο, Ὁ, Ὃ
Ω: Ω, Ὦ
α: ἃ, ἅ
η: ἡ, ἢ, ἣ, ἤ, ἥ, ᾖ, ᾗ
ο: ὁ, ὃ, ὅ
ω: ὦ, ᾧ
Εν: Ἐν, Ἓν, Ἕν
Εξ: Ἐξ, Ἓξ
Μη: Μή, Μὴ
Ου: Οὐ, Οὔ
Το: Τό, Τὸ
αι: αἱ, αἳ, αἵ
αν: ἂν, ἄν
γη: γῆ, γῇ
δε: δέ, δὲ
δη: δή, δὴ
ει: εἰ, εἴ, εἶ
εν: εν, ἐν, ἓν, ἔν, ἕν
εξ: ἐξ, ἓξ, ἕξ
ην: ἣν, ἥν, ἦν
ης: ἦς, ἧς, ᾖς
με: μέ, με
μη: μή, μὴ
οι: οἱ, οἳ, οἵ
ον: ὂν, ὃν
ος: ὃς, ὅς
ου: οὐ, οὒ, οὔ, οὗ
σα: σά, σὰ
σε: σέ, σε, σὲ
συ: σύ, σὺ
τα: τά, τὰ
τι: τί, τι
το: τό, τὸ
ων: ὢν, ὤν, ὧν
ως: ὡς, ὥς
Αρα: Ἄρα, Ἆρά
Εγω: Ἐγώ, Ἐγὼ
Και: Καί, Καὶ
Λωτ: Λώτ, Λὼτ
Υιε: Υἱέ, Υἱὲ
Ωδε: Ὧδέ, Ὧδε
ανω: ἀνῶ, ἄνω
απο: ἀπό, ἀπὸ
αρα: ἄρα, ἆρα
γαρ: γάρ, γὰρ
γης: γὴς, γῆς
γνω: γνῶ, γνῷ
δια: διά, διὰ
διο: διό, διὸ
δις: δίς, δὶς
δος: δός, δὸς
εαν: ἐάν, ἐὰν
εγω: ἐγώ, ἐγὼ
εις: εἰς, εἴς, εἷς
εμα: ἐμά, ἐμὰ
εμε: ἐμέ, ἐμὲ
εμη: ἐμή, ἐμὴ, ἐμῇ
ενι: ἑνί, ἑνὶ, ἔνι
επι: ἐπί, ἐπὶ
ζωη: ζωή, ζωὴ, ζωῇ
και: καί, καὶ
μεν: μέν, μὲν
μια: μία, μιᾷ
μοι: μοί, μοι
μου: μου, μού
ναι: ναί, ναὶ
νοι: νοΐ, νοῒ
νυξ: νύξ, νὺξ
οια: οἵα, οἷά, οἷα
ολη: ὅλη, ὅλῃ
οξυ: ὀξύ, ὀξὺ
ουκ: οὐκ, οὖκ
ους: οὓς, οὖς
που: που, πού, ποῦ
πως: πως, πῶς
σης: σὴς, σῆς
σοι: σοί, σοι, σοὶ
σου: σου, σού, σοῦ
συν: σύν, σὺν
την: τήν, τὴν
της: τὴς, τῆς
τις: τίς, τις
τον: τον, τόν, τὸν
υπο: ὑπό, ὑπὸ
ωρα: ὥρα, ὥρᾳ
ωτα: ὦτά, ὦτα
Αβια: Ἀβιά, Ἀβιὰ
Αδαμ: Ἀδάμ, Ἀδὰμ
Αζωρ: Ἀζώρ, Ἀζὼρ
Αμην: Ἀμήν, Ἀμὴν
Αμως: Ἀμώς, Ἀμὼς
Ανηρ: Ἀνήρ, Ἀνὴρ
Αραμ: Ἀράμ, Ἀρὰμ
Ασαφ: Ἀσάφ, Ἀσὰφ
Ασηρ: Ἀσήρ, Ἀσὴρ
Ασια: Ἀσία, Ἀσίᾳ
Αχαζ: Ἀχάζ, Ἀχὰζ
Αχιμ: Ἀχίμ, Ἀχὶμ
Ενωχ: Ἑνώχ, Ἑνὼχ
Καγω: Κἀγώ, Κἀγὼ
Κηφα: Κηφᾶ, Κηφᾷ
Οιδα: Οἶδά, Οἶδα
Ουαι: Οὐαί, Οὐαὶ
Ουχι: Οὐχί, Οὐχὶ
Ποια: Ποία, Ποῖα
Σινα: Σινά, Σινὰ
Σιων: Σιών, Σιὼν
Υιος: Υἱός, Υἱὸς
αγια: ἁγία, ἁγίᾳ, ἅγιά, ἅγια
αιμα: αἷμά, αἷμα
ακοη: ἀκοή, ἀκοὴ, ἀκοῇ
αλλα: αλλα, ἀλλά, ἀλλὰ, ἄλλα
αμην: ἀμήν, ἀμην, ἀμὴν
ανηρ: ἀνήρ, ἀνὴρ
αξια: ἀξία, ἄξια
αρας: ἀρᾶς, ἄρας
αρον: ἆρον, ἆρόν
αρχη: ἀρχή, ἀρχὴ, ἀρχῇ
αυτα: αὐτά, αὐτὰ
αυτη: αὐτὴ, αὐτῇ, αὕτη
αυτο: αὐτό, αὐτὸ
αυτω: αὐτῷ, αὑτῷ
γυνη: γυνή, γυνὴ
δους: δούς, δοὺς
δυσι: δυσί, δυσὶ
δωρα: δῶρά, δῶρα
ειμι: εἰμί, εἰμι, εἰμὶ, ἐιμι
ειπε: εἰπέ, εἰπὲ
εμην: ἐμήν, ἐμὴν
εμοι: ἐμοί, ἐμοὶ
εμον: ἐμόν, ἐμὸν
ενος: ἑνός, ἑνὸς
επτα: ἑπτά, ἑπτὰ
εστε: ἐστέ, ἐστε, ἐστὲ
ζηλω: ζήλῳ, ζηλῶ
ζυμη: ζύμη, ζύμῃ
ζωην: ζωήν, ζωὴν
θεον: θεόν, θεὸν
θεος: θεός, θεὸς
θυρα: θύρα, θύρᾳ
ιαθη: ἰάθη, ἰαθῇ
ιδια: ἰδίᾳ, ἴδια
ιδου: ἰδού, ἰδοὺ
ιδων: ἰδών, ἰδὼν
καγω: κἀγώ, κἀγὼ
κακα: κακά, κακὰ
κατα: κατά, κατὰ
λαον: λαόν, λαὸν
λαος: λαός, λαὸς
λεμα: λεμα, λεμὰ
λυπη: λύπη, λύπῃ
μενω: μένω, μενῶ
νοος: νοός, νοὸς
οδον: ὁδόν, ὁδὸν
οιδα: οἶδά, οἶδα
οιοι: οἷοί, οἷοι
οκτω: ὀκτώ, ὀκτὼ
οργη: ὀργή, ὀργὴ, ὀργῇ
ουαι: οὐαί, οὐαὶ
ουδε: οὐδε, οὐδὲ
ουχι: οὐχί, οὐχὶ
παθη: πάθη, πάθῃ
παρα: παρά, παρὰ
περι: περί, περὶ
πηγη: πηγὴ, πηγῇ
ποια: ποία, ποίᾳ
ποιω: ποίῳ, ποιῶ
πολυ: πολύ, πολὺ
ποτε: ποτέ, ποτε, ποτὲ, πότε
προς: πρός, πρὸς
πρωι: πρωί, πρωὶ
πυλη: πύλη, πύλῃ
πυρι: πυρί, πυρὶ
ρημα: ῥῆμά, ῥῆμα
σαρξ: σάρξ, σὰρξ
σκια: σκιὰ, σκιᾷ
συκη: συκῆ, συκῇ
σωμα: σῶμά, σῶμα
ταχυ: ταχύ, ταχὺ
τιμα: τίμα, τιμᾷ
τιμη: τιμὴ, τιμῇ
τινα: τίνα, τινά, τινα, τινὰ
τινι: τίνι, τινί, τινι, τινὶ
τους: τούς, τοὺς, τοῦς
τρις: τρίς, τρὶς
υιοι: υἱοί, υἱοὶ
υιον: υἱόν, υἱὸν, ὑιὸν
υιος: υἱός, υἱὸς, ὑιὸς
υιου: υἱοῦ, ὑιοῦ
υπερ: ὑπὲρ, ὕπερ
φημι: φημί, φημι
φωνη: φωνὴ, φωνῇ
φωτι: φωτί, φωτὶ
χαρα: χαρά, χαρὰ, χαρᾷ
χειρ: χείρ, χεὶρ
χωρα: χώρα, χώρᾳ
ψυχη: ψυχή, ψυχὴ, ψυχῇ
ωσιν: ὠσίν, ὠσὶν, ὦσιν
Ααρων: Ἀαρών, Ἀαρὼν
Αχαια: Ἀχαία, Ἀχαίᾳ
Δαυιδ: Δαυίδ, Δαυὶδ
Εσρωμ: Ἑσρώμ, Ἑσρὼμ
Εχετε: Ἔχετέ, Ἔχετε
Ιακωβ: Ἰακώβ, Ἰακὼβ
Ιουδα: Ἰούδα, Ἰούδᾳ
Ισαακ: Ἰσαάκ, Ἰσαὰκ
Ιωραμ: Ἰωράμ, Ἰωρὰμ
Ιωσηφ: Ἰωσήφ, Ἰωσὴφ
Κυριε: Κύριέ, Κύριε
Μαρια: Μαρία, Μαρίᾳ
Ουτοι: Οὗτοί, Οὗτοι
Ουτος: Οὗτος, Οὗτός
Σαδωκ: Σαδώκ, Σαδὼκ
Σαουλ: Σαούλ, Σαοὺλ
Συχεμ: Συχέμ, Συχὲμ
Ταυτα: Ταῦτά, Ταῦτα
Τινες: Τίνες, Τινὲς
Τουτο: Τοῦτο, Τοῦτό
Φαραω: Φαραώ, Φαραὼ
Φαρες: Φαρές, Φαρὲς
αγαθα: ἀγαθά, ἀγαθὰ
αγαθε: ἀγαθέ, ἀγαθὲ
αγαθη: ἀγαθὴ, ἀγαθῇ
αγαπη: ἀγάπη, ἀγάπῃ
αγιος: ἅγιος, ἅγιός
αγρον: ἀγρόν, ἀγρὸν
αγρος: ἀγρός, ἀγρὸς
αδικω: ἀδίκῳ, ἀδικῶ
αετοι: ἀετοί, ἀετοὶ
ακοην: ἀκοήν, ἀκοὴν
ανδρι: ἀνδρί, ἀνδρὶ
αξιοι: ἄξιοί, ἄξιοι
αξιον: ἄξιον, ἄξιόν
αξιος: ἄξιος, ἄξιός
απατη: ἀπάτη, ἀπάτῃ
αργαι: ἀργαί, ἀργαὶ
αρετη: ἀρετὴ, ἀρετῇ
αρχας: ἀρχάς, ἀρχὰς
ασκοι: ἀσκοί, ἀσκοὶ
ατινα: ἅτινά, ἅτινα
αυλην: αὐλήν, αὐλὴν
αυται: αὗταί, αὗται
αυτας: αὐτάς, αὐτὰς
αυτην: αὐτήν, αὐτὴν, αὑτὴν
αυτοι: αὐτοί, αὐτοὶ
αυτον: αὐτόν, αὐτὸν, αὑτὸν
αυτος: αὐτός, αὐτὸς
αυτου: αὐτοῦ, αὑτοῦ
αφεις: ἀφεὶς, ἀφεῖς
βουλη: βουλὴ, βουλῇ
βραχυ: βραχύ, βραχὺ
βρωμα: βρῶμά, βρῶμα
γαμων: γάμων, γαμῶν
γενεα: γενεὰ, γενεᾷ
γλυκυ: γλυκύ, γλυκὺ
γραφη: γραφή, γραφὴ, γραφῇ
δεξια: δεξιά, δεξιὰ, δεξιᾷ
δηλον: δῆλον, δῆλόν
δοκον: δοκόν, δοκὸν
δυσιν: δυσίν, δυσὶν
δωρεα: δωρεὰ, δωρεᾷ
δωρον: δῶρον, δῶρόν
εγγυς: ἐγγύς, ἐγγὺς
ειδες: εἶδές, εἶδες
ειδον: εἶδον, εἶδόν
ειδως: εἰδώς, εἰδὼς
ειναι: εἶναί, εἶναι, ἐιναι
ειπας: εἴπας, εἶπας
ειπεν: εἶπέν, εἶπεν
ειπης: εἴπης, εἴπῃς
ειπον: εἰπόν, εἰπὸν, εἶπον, εἶπόν
ειπων: εἰπών, εἰπὼν
εισιν: εἰσίν, εἰσιν, εἰσὶν
ειχεν: εἶχέν, εἶχεν
εκτος: ἐκτὸς, ἕκτος
ελπις: ἐλπίς, ἐλπὶς
εορτη: ἑορτὴ, ἑορτῇ
εσμεν: ἐσμέν, ἐσμεν, ἐσμὲν
εστιν: ἐστίν, ἐστιν, ἐστὶν, ἔστιν
ετερα: ἑτέρα, ἑτέρᾳ, ἕτερα
ευθυς: εὐθύς, εὐθὺς
ευρον: εὗρον, εὗρόν
ευρων: εὑρών, εὑρὼν
ευχην: εὐχήν, εὐχὴν
εχθρα: ἔχθρα, ἔχθρᾳ
ζητει: ζήτει, ζητεῖ
ζυγον: ζυγόν, ζυγὸν
ημερα: ἡμέρα, ἡμέρᾳ
θυμον: θυμόν, θυμὸν
θυμος: θυμός, θυμὸς
θυσια: θυσία, θυσίᾳ
ιαται: ἰᾶταί, ἴαται
ιδητε: ἴδητέ, ἴδητε
ιερον: ἱερόν, ἱερὸν
ισχυι: ἰσχύι, ἰσχύϊ
ιχθυν: ἰχθύν, ἰχθὺν
καθως: καθώς, καθὼς
καινα: καινά, καινὰ
καινη: καινή, καινὴ
κακια: κακία, κακίᾳ
κακον: κακόν, κακὸν
καλει: κάλει, καλεῖ
καλην: καλήν, καλὴν
καλον: καλόν, καλὸν
καλος: καλός, καλὸς
καμοι: κἀμοί, κἀμοὶ
κενον: κενόν, κενὸν
κλεις: κλεὶς, κλεῖς
κρινω: κρίνω, κρινῶ
κυρια: κυρία, κυρίᾳ
κωφον: κωφόν, κωφὸν
λαβων: λαβών, λαβὼν
λαλει: λάλει, λαλεῖ
λιμνη: λίμνη, λίμνῃ
λιμοι: λιμοί, λιμοὶ
λιμος: λιμός, λιμὸς
μενει: μένει, μενεῖ
μηδεν: μηδέν, μηδὲν
μητρι: μητρί, μητρὶ
μονην: μονὴν, μόνην
νοσων: νοσῶν, νόσων
νυκτι: νυκτί, νυκτὶ
ξηραν: ξηράν, ξηρὰν
οδους: ὁδούς, ὁδοὺς
οικια: οἰκία, οἰκίᾳ
οικον: οἶκον, οἶκόν
οικος: οἶκος, οἶκός
οικων: οἰκῶν, οἴκων
ομοια: ὁμοία, ὅμοια
ονομα: ὄνομά, ὄνομα
οργην: ὀργήν, ὀργὴν
οσιον: ὅσιον, ὅσιόν
ουδεν: οὐδέν, οὐδὲν
ουθεν: οὐθέν, οὐθὲν
ουτοι: οὗτοί, οὗτοι
ουτος: οὑτὸς, οὗτος, οὗτός
παιδα: παῖδά, παῖδα
παντι: παντί, παντὶ
πασαν: πᾶσάν, πᾶσαν
πατηρ: πατήρ, πατὴρ
πατρι: πατρί, πατρὶ
πετρα: πέτρα, πέτρᾳ
πιειν: πίειν, πιεῖν
πλανη: πλάνη, πλάνῃ
πληγη: πληγὴ, πληγῇ
ποιει: ποίει, ποιεῖ
πολλα: πολλά, πολλὰ
πολλη: πολλή, πολλὴ, πολλῇ
πολυν: πολύν, πολὺν
πολυς: πολύς, πολὺς
πορνη: πόρνη, πόρνῃ
ποσιν: ποσίν, ποσὶν
πραυς: πραΰς, πραῢς
πρωτη: πρώτη, πρώτῃ
πυραν: πυράν, πυρὰν
πυρος: πυρός, πυρὸς
σαρκι: σαρκί, σαρκὶ
σκηνη: σκηνὴ, σκηνῇ
σοφια: σοφία, σοφίᾳ
σοφοι: σοφοί, σοφοὶ
σοφος: σοφός, σοφὸς
σωσον: σῶσον, σῶσόν
ταυτα: ταῦτά, ταῦτα
ταυτη: ταύτη, ταύτῃ
τηρει: τήρει, τηρεῖ
τιμην: τιμήν, τιμὴν
τινας: τίνας, τινάς, τινας, τινὰς
τινες: τίνες, τινές, τινες, τινὲς
τινος: τίνος, τινος, τινός, τινὸς
τινων: τίνων, τινων, τινῶν
τισιν: τισίν, τισιν, τισὶν
τουτο: τοῦτο, τοῦτό
τριτη: τρίτη, τρίτῃ
τροφη: τροφή, τροφὴ
υγιης: ὑγιής, ὑγιὴς
υετον: ὑετόν, ὑετὸν
υιους: υἱούς, υἱοὺς
φησιν: φησίν, φησιν
φθορα: φθορὰ, φθορᾷ
φιλων: φίλων, φιλῶν
φοβου: φοβοῦ, φόβου
φωνας: φωνάς, φωνὰς
φωνει: φωνεῖ, φώνει
φωνην: φωνήν, φωνὴν
φωτος: φωτός, φωτὸς
χαμαι: χαμαί, χαμαὶ
χαραν: χαράν, χαρὰν
χειρα: χεῖρά, χεῖρα
χειρι: χειρί, χειρὶ
χωλον: χωλόν, χωλὸν
χωρις: χωρίς, χωρὶς
ψυχαι: ψυχαί, ψυχαὶ
ψυχας: ψυχάς, ψυχὰς
ψυχην: ψυχήν, ψυχὴν
Αβιουδ: Ἀβιούδ, Ἀβιοὺδ
Αβρααμ: Ἀβραάμ, Ἀβραὰμ
Απολλω: Ἀπολλώ, Ἀπολλὼ
Βαλααμ: Βαλαάμ, Βαλαὰμ
Εγραψα: Ἔγραψά, Ἔγραψα
Ελιουδ: Ἐλιούδ, Ἐλιοὺδ
Ιεριχω: Ἰεριχώ, Ἰεριχὼ
Ιεσσαι: Ἰεσσαί, Ἰεσσαὶ
Ιησους: Ἰησοὺς, Ἰησοῦς
Ισραηλ: Ἰσραήλ, Ἰσραὴλ
Ιωαθαμ: Ἰωαθάμ, Ἰωαθὰμ
Κυριος: Κύριος, Κύριός
Λεγιων: Λεγιών, Λεγιὼν
Μαθθατ: Μαθθάτ, Μαθθὰτ
Μαριαμ: Μαριάμ, Μαριὰμ
Ματθαν: Ματθάν, Ματθὰν
Ναζαρα: Ναζαρά, Ναζαρὰ
Ουδεις: Οὐδείς, Οὐδεὶς
Ροβοαμ: Ῥοβοάμ, Ῥοβοὰμ
Σαλμων: Σαλμών, Σαλμὼν
Σατανα: Σατανᾶ, Σατανᾷ
Σιλωαμ: Σιλωάμ, Σιλωὰμ
Σιμωνα: Σίμωνά, Σίμωνα
Συμεων: Συμεών, Συμεὼν
Ταρσον: Ταρσόν, Ταρσὸν
Ωσαννα: Ὡσαννά, Ὡσαννὰ
αγαθην: ἀγαθήν, ἀγαθὴν
αγαθον: ἀγαθόν, ἀγαθὸν
αγαθος: ἀγαθός, ἀγαθὸς
αγρους: ἀγρούς, ἀγροὺς
αδελφη: ἀδελφή, ἀδελφὴ, ἀδελφῇ
αδικια: ἀδικία, ἀδικίᾳ
αδικος: ἄδικος, ἄδικός
αδικων: ἀδίκων, ἀδικῶν
αιματι: αἵματί, αἵματι
αιωνας: αἰωνας, αἰῶνας
αιωνος: αἰῶνος, αἰῶνός
αληθες: ἀληθές, ἀληθὲς
αληθης: ἀληθής, ἀληθὴς
αλυσιν: ἅλυσίν, ἅλυσιν
αναγκη: ἀνάγκη, ἀνάγκῃ
ανδρος: ἀνδρός, ἀνδρὸς
ανομια: ἀνομία, ἀνομίᾳ
ανωθεν: ἄνωθέν, ἄνωθεν
αργους: ἀργούς, ἀργοὺς
ασκους: ἀσκούς, ἀσκοὺς
ατιμια: ἀτιμία, ἀτιμίᾳ
αυτους: αὐτούς, αὐτοὺς, αὑτούς, αὑτοὺς
αφηκεν: ἀφῆκέν, ἀφῆκεν
αφησει: ἀφήσει, ἀφησεὶ
γενεαι: γενεαί, γενεαὶ
γενεας: γενεάς, γενεὰς, γενεᾶς
γλωσσα: γλῶσσά, γλῶσσα
γνωναι: γνῶναί, γνῶναι
γονατα: γόνατά, γόνατα
γραφαι: γραφαί, γραφαὶ
γραφας: γραφάς, γραφὰς
γραφην: γραφήν, γραφὴν
γραφων: γράφων, γραφῶν
γυμνος: γυμνός, γυμνὸς
δεκτος: δεκτός, δεκτὸς
δεξιας: δεξιὰς, δεξιᾶς
δεξιον: δεξιόν, δεξιὸν
δεομαι: δέομαί, δέομαι
διδαχη: διδαχή, διδαχὴ, διδαχῇ
δικαια: δίκαια, δικαία
δοκιμη: δοκιμὴ, δοκιμῇ
δουλοι: δοῦλοί, δοῦλοι
δουλον: δοῦλον, δοῦλόν
δουλος: δοῦλος, δοῦλός
δουναι: δοῦναί, δοῦναι
δυνατα: δυνατά, δυνατὰ
δωρεαν: δωρεάν, δωρεὰν
εαυτας: ἑαυτάς, ἑαυτὰς
εαυτην: ἑαυτήν, ἑαυτὴν
εαυτον: ἑαυτόν, ἑαυτὸν
εγραψα: ἔγραψά, ἔγραψα
εδωκας: ἔδωκάς, ἔδωκας
εδωκεν: ἔδωκέν, ἔδωκεν
ειπατε: εἴπατέ, εἴπατε
ειπητε: εἴπητέ, εἴπητε
ειρηνη: εἰρήνη, εἰρήνῃ
εκατον: ἑκατόν, ἑκατὸν
εκεινη: ἐκείνη, ἐκείνῃ
εκρινα: ἔκρινά, ἔκρινα
ενοχος: ἔνοχος, ἔνοχός
εντολη: ἐντολή, ἐντολὴ
εορτην: ἑορτήν, ἑορτὴν
ερειτε: ἐρεῖτέ, ἐρεῖτε
εσεσθε: ἔσεσθέ, ἔσεσθε
εσχατη: ἐσχάτη, ἐσχάτῃ
ετοιμα: ἕτοιμά, ἕτοιμα
ευρεθη: εὑρέθη, εὑρεθῇ
ευρηκα: εὕρηκά, εὕρηκα
εχθροι: ἐχθροί, ἐχθροὶ
εχθρον: ἐχθρόν, ἐχθρὸν
εχοντα: ἔχοντά, ἔχοντα
ζεστος: ζεστός, ζεστὸς
θελετε: θέλετέ, θέλετε
θελημα: θέλημά, θέλημα
ιερευς: ἱερεύς, ἱερεὺς
ικαναι: ἱκαναί, ἱκαναὶ
ικανοι: ἱκανοί, ἱκανοὶ
ικανον: ἱκανόν, ἱκανὸν
ικανος: ἱκανός, ἱκανὸς
ιματια: ἱμάτιά, ἱμάτια
ισχυρα: ἰσχυρά, ἰσχυρὰ, ἰσχυρᾷ
καθαρα: καθαρὰ, καθαρᾷ
καινην: καινήν, καινὴν
καινον: καινόν, καινὸν
καιρον: καιρόν, καιρὸν
καιρος: καιρός, καιρὸς
κακους: κακούς, κακοὺς
καρδια: καρδία, καρδίᾳ
καρπον: καρπόν, καρπὸν
καρπος: καρπός, καρπὸς
κεφαλη: κεφαλή, κεφαλὴ, κεφαλῇ
κλητοι: κλητοί, κλητοὶ
κοιλια: κοιλία, κοιλίᾳ
κραυγη: κραυγὴ, κραυγῇ
κρινει: κρίνει, κρινεῖ
κριτην: κριτήν, κριτὴν
κριτης: κριτής, κριτὴς
κυριον: κύριον, κύριόν
κυριος: κύριος, κύριός
κωφους: κωφούς, κωφοὺς
λαμπρα: λαμπρὰ, λαμπρᾷ
λευκαι: λευκαί, λευκαὶ
λευκας: λευκάς, λευκὰς
λευκην: λευκήν, λευκὴν
λευκον: λευκόν, λευκὸν
λευκος: λευκός, λευκὸς
λησται: λῃσταί, λῃσταὶ
λοιποι: λοιποί, λοιποὶ
λοιπον: λοιπόν, λοιπὸν
μακραν: μακράν, μακρὰν
μαμωνα: μαμωνᾶ, μαμωνᾷ
μεγαλη: μεγάλη, μεγάλῃ
μειζον: μεῖζον, μεῖζόν
μεστον: μεστόν, μεστὸν
μηδεις: μηδείς, μηδεὶς
μητρος: μητρός, μητρὸς
μικρον: μικρόν, μικρὸν
μισθος: μισθός, μισθὸς
μοιχοι: μοιχοί, μοιχοὶ
νεκροι: νεκροί, νεκροὶ
νεκρος: νεκρός, νεκρὸς
νεφελη: νεφέλη, νεφέλῃ
νηπιος: νήπιος, νήπιός
νυκτος: νυκτός, νυκτὸς
ογδοος: ὄγδοος, ὄγδοός
οδηγοι: ὁδηγοί, ὁδηγοὶ
οιδατε: οἰδατε, οἴδατε
ομοιοι: ὅμοιοί, ὅμοιοι
ομοιος: ὅμοιος, ὅμοιός
ουδεις: οὐδείς, οὐδεὶς
ουρανω: οὐρανῳ, οὐρανῷ
οφελον: ὄφελον, ὄφελόν
οψεσθε: ὄψεσθέ, ὄψεσθε
παιδος: παιδός, παιδὸς
παλαια: παλαιά, παλαιᾷ
παντος: παντός, παντὸς
παραδω: παραδῶ, παραδῷ
πατρος: πατρός, πατρὸς
πικρον: πικρόν, πικρὸν
πιστοι: πιστοί, πιστοὶ
πιστον: πιστόν, πιστὸν
πιστος: πιστός, πιστὸς
πλειον: πλεῖον, πλεῖόν
πνευμα: πνεῦμά, πνεῦμα
ποιμην: ποιμήν, ποιμὴν
πολλαι: πολλαί, πολλαὶ
πολλας: πολλάς, πολλὰς
πολλην: πολλήν, πολλὴν
πολλοι: πολλοί, πολλοὶ
πονηρα: πονηρά, πονηρὰ, πονηρᾷ
πονηρε: πονηρέ, πονηρὲ
πρωτης: πρωτης, πρώτης
πρωτον: πρῶτον, πρῶτόν
πρωτος: πρῶτος, πρῶτός
πτωχοι: πτωχοί, πτωχοὶ
πτωχον: πτωχόν, πτωχὸν
ρηματα: ῥήματά, ῥήματα
ρηματι: ῥήματί, ῥήματι
σαπρον: σαπρόν, σαπρὸν
σαρκος: σαρκός, σαρκὸς
σεληνη: σελήνη, σελήνῃ
σκευος: σκεῦος, σκεῦός
σκηνας: σκηνάς, σκηνὰς
σκηνην: σκηνήν, σκηνὴν
σκοτια: σκοτία, σκοτίᾳ
σοφους: σοφούς, σοφοὺς
στειρα: στείρᾳ, στεῖρα
σωματι: σώματί, σώματι
σωτηρι: σωτῆρί, σωτῆρι
τρισιν: τρισίν, τρισὶν
τυφλοι: τυφλοί, τυφλοὶ
τυφλον: τυφλόν, τυφλὸν
τυφλος: τυφλός, τυφλὸς
υπακοη: ὑπακοή, ὑπακοῇ
υψηλον: ὑψηλόν, ὑψηλὸν
φανερα: φανερά, φανερὰ
φερετε: φέρετέ, φέρετε
φθοραν: φθοράν, φθορὰν
φονευς: φονεύς, φονεὺς
φρεσιν: φρεσίν, φρεσὶν
φυλακη: φυλακὴ, φυλακῇ
χαλκον: χαλκόν, χαλκὸν
χαρητε: χάρητε, χαρῆτε
χαριτι: χάριτί, χάριτι
χειμων: χειμών, χειμὼν
χειρας: χεῖράς, χεῖρας
χειρον: χεῖρον, χεῖρόν
χειρος: χειρός, χειρὸς
χειρων: χείρων, χειρῶν
χερσιν: χερσίν, χερσὶν
χιτωνα: χιτῶνά, χιτῶνα
χλωρος: χλωρός, χλωρὸς
χρυσον: χρυσόν, χρυσὸν
χωλους: χωλούς, χωλοὺς
ψυχρος: ψυχρός, ψυχρὸς
Αναστας: Ἀναστάς, Ἀναστὰς
Απολλως: Ἀπολλώς, Ἀπολλὼς
Βαρναβα: Βαρνάβα, Βαρνάβᾳ
Βηθανια: Βηθανία, Βηθανίᾳ
Βηθλεεμ: Βηθλεέμ, Βηθλεὲμ
Ελεησον: Ἐλέησον, Ἐλέησόν
Ελιακιμ: Ἐλιακίμ, Ἐλιακὶμ
Ελληνες: Ἕλληνές, Ἕλληνες
Ελλησιν: Ἕλλησίν, Ἕλλησιν
Ιουδαια: Ἰουδαία, Ἰουδαίᾳ
Ιωσαφατ: Ἰωσαφάτ, Ἰωσαφὰτ
Καισαρα: Καίσαρά, Καίσαρα
Καισαρι: Καίσαρί, Καίσαρι
Ναασσων: Ναασσών, Ναασσὼν
Ναζαρεθ: Ναζαρέθ, Ναζαρὲθ
Ναζαρετ: Ναζαρέτ, Ναζαρὲτ
Ρωμαιοι: Ῥωμαῖοί, Ῥωμαῖοι
Ρωμαιος: Ῥωμαῖος, Ῥωμαῖός
Χριστον: Χριστόν, Χριστὸν
Χριστος: Χριστός, Χριστὸς
αγαγετε: ἀγάγετέ, ἀγάγετε
αγαθους: ἀγαθούς, ἀγαθοὺς
αγαπατε: ἀγαπᾶτέ, ἀγαπᾶτε
αγαπητα: ἀγαπητά, ἀγαπητὰ
αγγελοι: ἄγγελοί, ἄγγελοι
αγγελον: ἄγγελον, ἄγγελόν
αγγελος: ἄγγελος, ἄγγελός
αδελφαι: ἀδελφαί, ἀδελφαὶ
αδελφας: ἀδελφάς, ἀδελφὰς
αδελφοι: ἀδελφοί, ἀδελφοὶ
αδελφον: ἀδελφόν, ἀδελφὸν
αδελφος: ἀδελφός, ἀδελφὸς
αδικημα: ἀδίκημά, ἀδίκημα
αιματος: αἵματος, αἵματός
αισχρον: αἰσχρόν, αἰσχρὸν
αισχυνη: αἰσχύνη, αἰσχύνῃ
αιωνιος: αἰώνιος, αἰώνιός
ακαρπος: ἄκαρπος, ἄκαρπός
ακουσαι: ἀκοῦσαί, ἀκοῦσαι
αληθεια: ἀλήθειά, ἀλήθεια, ἀληθείᾳ
αληθινη: ἀληθινή, ἀληθινὴ
αμαρτια: ἁμαρτία, ἁμαρτίᾳ
ανατολη: ἀνατολὴ, ἀνατολῇ
ανοητοι: ἀνόητοί, ἀνόητοι
απηλθον: ἀπῆλθον, ἀπῆλθόν
απιστια: ἀπιστία, ἀπιστίᾳ
αριστον: ἄριστον, ἄριστόν
αρουσιν: ἀροῦσίν, ἀροῦσιν
ασθενης: ἀσθενής, ἀσθενὴς
αστραπη: ἀστραπὴ, ἀστραπῇ
ασφαλες: ἀσφαλές, ἀσφαλὲς
αφορμην: ἀφορμήν, ἀφορμὴν
βιωτικα: βιωτικά, βιωτικὰ
βρονται: βρονταί, βρονταὶ
γεγονος: γεγονός, γεγονὸς
γενηται: γένηταί, γένηται
γενοιτο: γένοιτο, γένοιτό
γλωσσαν: γλῶσσάν, γλῶσσαν
γυναικα: γυναῖκά, γυναῖκα
γυναικι: γυναικί, γυναικὶ
δεδωκας: δέδωκάς, δέδωκας
δεδωκεν: δέδωκέν, δέδωκεν
δεξασθε: δέξασθέ, δέξασθε
δευτερα: δευτέρα, δευτέρᾳ
διαθηκη: διαθήκη, διαθήκῃ
διδωσιν: δίδωσίν, δίδωσιν
διεθετο: διέθετο, διέθετό
δικαιοι: δίκαιοι, δικαιοῖ
δικαιον: δίκαιον, δίκαιόν
δικαιος: δίκαιος, δίκαιός
δοκιμην: δοκιμήν, δοκιμὴν
δυναμαι: δύναμαί, δύναμαι
δυναμιν: δύναμίν, δύναμιν
δυνασαι: δύνασαί, δύνασαι
δυναται: δύναταί, δύναται
δυνατοι: δυνατοί, δυνατοὶ
δυνατον: δυνατόν, δυνατὸν
δυνατος: δυνατός, δυνατὸς
εαυτους: ἑαυτούς, ἑαυτοὺς
εβρεξεν: ἔβρεξέν, ἔβρεξεν
εδειξεν: ἔδειξέν, ἔδειξεν
εθνικοι: ἐθνικοί, ἐθνικοὶ
ειδομεν: εἴδομέν, εἴδομεν
ειδωλον: εἴδωλον, εἴδωλόν
ειρηκεν: εἴρηκέν, εἴρηκεν
εκειθεν: ἐκεῖθέν, ἐκεῖθεν
εκειναι: ἐκεῖναί, ἐκεῖναι
εκεινοι: ἐκεῖνοί, ἐκεῖνοι
εκεινος: ἐκεῖνος, ἐκεῖνός
ελαφρον: ἐλαφρόν, ἐλαφρὸν
ελεησον: ἐλέησον, ἐλέησόν
εμαυτον: ἐμαυτόν, ἐμαυτὸν
εμποροι: ἔμποροί, ἔμποροι
ενδικον: ἔνδικον, ἔνδικόν
ενεργης: ἐνεργής, ἐνεργὴς
εντολας: ἐντολάς, ἐντολὰς
εντολην: ἐντολήν, ἐντολὴν
ενωπιον: ἐνώπιον, ἐνώπιόν
εξεστιν: ἔξεστίν, ἔξεστιν
εξουσια: ἐξουσία, ἐξουσίᾳ
ερουσιν: ἐροῦσίν, ἐροῦσιν
ερχεται: ἔρχεταί, ἔρχεται
ερχομαι: ἔρχομαί, ἔρχομαι
εσονται: ἔσονταί, ἔσονται
εστηκεν: ἔστηκεν, ἕστηκεν
εστησαν: ἔστησάν, ἔστησαν
ετοιμοι: ἕτοιμοί, ἕτοιμοι
ετοιμος: ἕτοιμος, ἕτοιμός
ευθετον: εὔθετον, εὔθετόν
ευλαβης: εὐλαβής, εὐλαβὴς
ευλογια: εὐλογία, εὐλογίᾳ
εχθρους: ἐχθρούς, ἐχθροὺς
εχρισεν: ἔχρισέν, ἔχρισεν
εωρακας: ἑώρακάς, ἑώρακας
εωρακεν: ἑώρακέν, ἑώρακεν
ζηλωται: ζηλωταί, ζηλωταὶ
ζητειτε: ζητεῖτέ, ζητεῖτε
ζιζανια: ζιζάνιά, ζιζάνια
ηγαπατε: ἠγαπᾶτέ, ἠγαπᾶτε
ηγαπησα: ἠγάπησά, ἠγάπησα
ηκουσας: ἤκουσάς, ἤκουσας
ηλεησεν: ἠλέησέν, ἠλέησεν
ηνοιξεν: ἤνοιξέν, ἤνοιξεν
ηρξαντο: ἤρξαντο, ἤρξαντό
θελοντι: θέλοντί, θέλοντι
θυρωρος: θυρωρός, θυρωρὸς
ικανους: ἱκανούς, ἱκανοὺς
ιματιον: ἱμάτιον, ἱμάτιόν
ισχυροι: ἰσχυροί, ἰσχυροὶ
ισχυρον: ἰσχυρόν, ἰσχυρὸν
καθαροι: καθαροί, καθαροὶ
καθαρον: καθαρόν, καθαρὸν
καθαρος: καθαρός, καθαρὸς
καινους: καινούς, καινοὺς
καρπους: καρπούς, καρποὺς
καταβας: καταβάς, καταβὰς
καυχημα: καύχημά, καύχημα
κεφαλας: κεφαλάς, κεφαλὰς
κεφαλην: κεφαλήν, κεφαλὴν
κηρυγμα: κήρυγμά, κήρυγμα
κιβωτον: κιβωτόν, κιβωτὸν
κυλλους: κυλλούς, κυλλοὺς
κωλυσαι: κωλῦσαί, κωλῦσαι
λαλησαι: λαλῆσαί, λαλῆσαι
λεγοντα: λέγοντά, λέγοντα
μαθηται: μαθηταί, μαθηταὶ
μαθητας: μαθητάς, μαθητὰς
μαθητης: μαθητής, μαθητὴς
μελεσιν: μέλεσίν, μέλεσιν
μεριμνα: μέριμνα, μεριμνᾷ
μικρους: μικρούς, μικροὺς
μιμηται: μιμηταί, μιμηταὶ
νεκρους: νεκρούς, νεκροὺς
νομικος: νομικός, νομικὸς
οιτινες: οἵτινές, οἵτινες
ονοματα: ὀνόματά, ὀνόματα
ονοματι: ὀνόματί, ὀνόματι
ουδενος: οὐδενός, οὐδενὸς
ουρανοι: οὐρανοί, οὐρανοὶ
ουρανον: οὐρανόν, οὐρανὸν
ουρανος: οὐρανός, οὐρανὸς
παιδεια: παιδεία, παιδείᾳ
παλαιον: παλαιόν, παλαιὸν
παντοτε: πάντοτέ, πάντοτε
πιστεως: πίστεως, πίστεώς
πλευραν: πλευράν, πλευρὰν
ποιησον: ποίησον, ποίησόν
ποιητης: ποιητής, ποιητὴς
πολλους: πολλούς, πολλοὺς
πονηροι: πονηροί, πονηροὶ
πονηρον: πονηρόν, πονηρὸν
πονηρος: πονηρός, πονηρὸς
πορνεια: πορνεία, πορνείᾳ
ποταμον: ποταμόν, ποταμὸν
ποταμος: ποταμός, ποταμὸς
προβατα: πρόβατά, πρόβατα
πτωχεια: πτωχεία, πτωχείᾳ
πτωχους: πτωχούς, πτωχοὺς
πωλησον: πώλησον, πώλησόν
ρομφαια: ῥομφαία, ῥομφαίᾳ
ρυσεται: ῥύσεταί, ῥύσεται
σεαυτον: σεαυτόν, σεαυτὸν
σεισμοι: σεισμοί, σεισμοὶ
σεισμος: σεισμός, σεισμὸς
σημειον: σημεῖον, σημεῖόν
σπουδην: σπουδήν, σπουδὴν
σταυρου: σταυροῦ, σταύρου
στοματι: στόματί, στόματι
συνεσιν: σύνεσίν, σύνεσιν
σωματος: σώματος, σώματός
ταμειον: ταμεῖον, ταμεῖόν
τελειος: τέλειος, τέλειός
τυφλους: τυφλούς, τυφλοὺς
υμετερα: ὑμετέρα, ὑμετέρᾳ
υπακοην: ὑπακοήν, ὑπακοὴν
υπηκοοι: ὑπήκοοί, ὑπήκοοι
υπομονη: ὑπομονὴ, ὑπομονῇ
φανερον: φανερόν, φανερὸν
φυλακας: φυλακάς, φυλακὰς, φύλακας
φυλακην: φυλακήν, φυλακὴν
χαλεποι: χαλεποί, χαλεποὶ
χρηστος: χρηστός, χρηστὸς
χριστον: χριστόν, χριστὸν
χριστος: χριστός, χριστὸς
ωρμησαν: ὥρμησάν, ὥρμησαν
Ακουσατε: Ἀκούσατέ, Ἀκούσατε
Αμιναδαβ: Ἀμιναδάβ, Ἀμιναδὰβ
Ανθρωπος: Ἄνθρωπος, Ἄνθρωπός
Βενιαμιν: Βενιαμίν, Βενιαμὶν
Βηθσαιδα: Βηθσαιδά, Βηθσαιδὰ, Βηθσαϊδά
Γαλιλαια: Γαλιλαία, Γαλιλαίᾳ
Δαμασκον: Δαμασκόν, Δαμασκὸν
Εβραιστι: Ἐβραϊστί, Ἐβραϊστὶ
Εκτεινον: Ἔκτεινον, Ἔκτεινόν
Ιουδαιοι: Ἰουδαῖοί, Ἰουδαῖοι
Ιουδαιος: Ἰουδαῖος, Ἰουδαῖός
Ισκαριωθ: Ἰσκαριώθ, Ἰσκαριὼθ
Καισαρος: Καίσαρος, Καίσαρός
Ναθαναηλ: Ναθαναήλ, Ναθαναὴλ
Νεφθαλιμ: Νεφθαλίμ, Νεφθαλὶμ
Σαλαθιηλ: Σαλαθιήλ, Σαλαθιὴλ
Σαμαρεια: Σαμάρεια, Σαμαρείᾳ
αγαπητοι: ἀγαπητοί, ἀγαπητοὶ
αγαπητον: ἀγαπητόν, ἀγαπητὸν
αγαπητος: ἀγαπητός, ἀγαπητὸς
αδελφους: ἀδελφούς, ἀδελφοὺς
αδοκιμοι: ἀδόκιμοί, ἀδόκιμοι
αδυνατον: ἀδύνατον, ἀδύνατόν
αιγιαλον: αἰγιαλόν, αἰγιαλὸν
αιροντος: αἴροντος, αἴροντός
αιτησητε: αἰτήσητέ, αἰτήσητε
αιτουντι: αἰτοῦντί, αἰτοῦντι
ακαθαρτα: ἀκάθαρτά, ἀκάθαρτα
ακουσατε: ἀκούσατέ, ἀκούσατε
αληθινοι: ἀληθινοί, ἀληθινοὶ
αληθινον: ἀληθινόν, ἀληθινὸν
αληθινος: ἀληθινός, ἀληθινὸς
αναγαγων: ἀναγαγών, ἀναγαγὼν
ανεχεσθε: ἀνέχεσθέ, ἀνέχεσθε
ανθρωποι: ἄνθρωποί, ἄνθρωποι
ανθρωπον: ἄνθρωπον, ἄνθρωπόν
ανθρωπος: ἄνθρωπος, ἄνθρωπός
απεθανεν: απέθανεν, ἀπέθανεν
απελιπον: ἀπέλιπον, ἀπέλιπόν
απολογια: ἀπολογία, ἀπολογίᾳ
απολυσαι: ἀπολῦσαί, ἀπολῦσαι
απολωλος: ἀπολωλός, ἀπολωλὸς
αργυριον: ἀργύριον, ἀργύριόν
αρξασθαι: ἄρξασθαί, ἄρξασθαι
ασελγεια: ἀσέλγεια, ἀσελγείᾳ
ασθενεια: ἀσθένεια, ἀσθενείᾳ
ασφαλεια: ἀσφάλεια, ἀσφαλείᾳ
αυστηρος: αὐστηρός, αὐστηρὸς
αφεωνται: ἀφέωνταί, ἀφέωνται
αφροσυνη: ἀφροσύνη, ἀφροσύνῃ
αψαμενος: ἁψάμενος, ἁψάμενός
βασιλεια: βασιλεία, βασιλείᾳ
βασιλευς: βασιλεύς, βασιλεὺς
γεωργους: γεωργούς, γεωργοὺς
γινομενη: γινομένη, γινομένῃ
γυναικες: γυναῖκές, γυναῖκες
γυναικος: γυναικός, γυναικὸς
γυναιξιν: γυναιξίν, γυναιξὶν
δεησεσιν: δεήσεσίν, δεήσεσιν
δεξωνται: δέξωνταί, δέξωνται
δευτερος: δεύτερος, δεύτερός
διαβολος: διάβολος, διάβολός
διακονει: διακονεῖ, διακόνει
διακονια: διακονία, διακονίᾳ
διηνεκες: διηνεκές, διηνεκὲς
δικαστην: δικαστήν, δικαστὴν
δοθεισαν: δοθεῖσάν, δοθεῖσαν
δρεπανον: δρέπανον, δρέπανόν
δυναμεθα: δυνάμεθά, δυνάμεθα
δυναμενα: δυνάμενά, δυνάμενα
δυνανται: δύνανταί, δύνανται
εγνωκατε: ἐγνώκατέ, ἐγνώκατε
εδεξασθε: ἐδέξασθέ, ἐδέξασθε
εδιδαξεν: ἐδίδαξέν, ἐδίδαξεν
εισηλθον: εἰσῆλθον, εἰσῆλθόν
εκκλησια: ἐκκλησία, ἐκκλησίᾳ
εκλεκτοι: ἐκλεκτοί, ἐκλεκτοὶ
εκλεκτον: ἐκλεκτόν, ἐκλεκτὸν
ελαλησεν: ἐλάλησέν, ἐλάλησεν
ενιαυτον: ἐνιαυτόν, ἐνιαυτὸν
εξαγαγων: ἐξαγαγών, ἐξαγαγὼν
εξειλατο: ἐξείλατο, ἐξείλατό
επεθηκεν: ἐπέθηκέν, ἐπέθηκεν
επιγραφη: ἐπιγραφή, ἐπιγραφὴ
επιθυμια: ἐπιθυμία, ἐπιθυμίᾳ
επιστολη: ἐπιστολή, ἐπιστολὴ, ἐπιστολῇ
επιταγην: ἐπιταγήν, ἐπιταγὴν
εποιησεν: ἐποίησέν, ἐποίησεν
ερωτησαι: ἐρωτῆσαί, ἐρωτῆσαι
ετηρησας: ἐτήρησάς, ἐτήρησας
ευρησετε: εὑρήσετέ, εὑρήσετε
ευρισκον: εὑρίσκον, εὕρισκον
ευσεβεια: εὐσέβεια, εὐσεβείᾳ
εωρακατε: ἑωράκατέ, ἑωράκατε
ζητηματα: ζητήματά, ζητήματα
ζητουσιν: ζητοῦσίν, ζητοῦσιν
ηγαπησας: ἠγάπησάς, ἠγάπησας
ηγαπησεν: ἠγάπησέν, ἠγάπησεν
ηδικησεν: ἠδίκησέν, ἠδίκησεν
ηκουσατε: ἠκούσατέ, ἠκούσατε
θεληματα: θελήματά, θελήματα
θελοντες: θέλοντές, θέλοντες
θερισμον: θερισμόν, θερισμὸν
θερισμος: θερισμός, θερισμὸς
θεωρειτε: θεωρεῖτέ, θεωρεῖτε
θησαυρος: θησαυρός, θησαυρὸς
θλιψεσιν: θλίψεσίν, θλίψεσιν
θρησκεια: θρησκεία, θρησκείᾳ
θυγατρος: θυγατρός, θυγατρὸς
καιομενη: καιομένη, καιομένῃ
κακεινος: κἀκεῖνος, κἀκεῖνός
καταλυμα: κατάλυμά, κατάλυμα
κατηλθεν: κατῆλθέν, κατῆλθεν
κεκληται: κέκληταί, κέκληται
κελευσον: κέλευσον, κέλευσόν
κερδησαι: κερδῆσαί, κερδῆσαι
κοινωνει: κοινωνεῖ, κοινώνει
κοινωνια: κοινωνία, κοινωνίᾳ
κοινωνοι: κοινωνοί, κοινωνοὶ
κοινωνος: κοινωνός, κοινωνὸς
κρειττον: κρεῖττον, κρεῖττόν
λεγουσιν: λέγουσίν, λέγουσιν
λημψεται: λήμψεταί, λήμψεται
μακαριοι: μακάριοί, μακάριοι
μακαριος: μακάριος, μακάριός
μαρτυρες: μάρτυρές, μάρτυρες
μαρτυρων: μαρτυρῶν, μαρτύρων
μαρτυσιν: μάρτυσίν, μάρτυσιν
μαστιγος: μάστιγος, μάστιγός
μαχαιραν: μάχαιράν, μάχαιραν
μισθωτος: μισθωτός, μισθωτὸς
μνησθητι: μνήσθητί, μνήσθητι
νεοτητος: νεότητος, νεότητός
οικοδομη: οἰκοδομή, οἰκοδομὴ
ονοματος: ὀνόματος, ὀνόματός
ορφανους: ὀρφανούς, ὀρφανοὺς
ουρανοις: οὐρανοις, οὐρανοῖς
ουρανους: οὐρανούς, οὐρανοὺς
οφθαλμοι: ὀφθαλμοί, ὀφθαλμοὶ
οφθαλμος: ὀφθαλμός, ὀφθαλμὸς
παντελες: παντελές, παντελὲς
παραβολη: παραβολή, παραβολὴ, παραβολῇ
παραδους: παραδούς, παραδοὺς
παρειναι: παρεῖναί, παρεῖναι
παρουσια: παρουσία, παρουσίᾳ
παρρησια: παρρησία, παρρησίᾳ
πεμψαντα: πέμψαντά, πέμψαντα
πενθεραν: πενθεράν, πενθερὰν
περισσον: περισσόν, περισσὸν
περιτομη: περιτομή, περιτομὴ, περιτομῇ
πλειονες: πλείονές, πλείονες
πνευματι: πνεύματί, πνεύματι
πονηρους: πονηρούς, πονηροὺς
ποτηριον: ποτήριον, ποτήριόν
προβατον: πρόβατον, πρόβατόν
προσευχη: προσευχὴ, προσευχῇ, προσεύχῃ
προσφορα: προσφορά, προσφορὰ, προσφορᾷ
προσωπον: πρόσωπον, πρόσωπόν
σανδαλια: σανδάλιά, σανδάλια
σιτευτον: σιτευτόν, σιτευτὸν
σπερματι: σπέρματί, σπέρματι
στεφανον: στέφανον, στέφανόν
στεφανος: στέφανος, στέφανός
στοματος: στόματος, στόματός
συναγωγη: συναγωγὴ, συναγωγῇ
συνεργοι: συνεργοί, συνεργοὶ
συνηθεια: συνήθεια, συνηθείᾳ
σωτηριον: σωτήριον, σωτήριόν
υπερβολη: ὑπερβολὴ, ὑπερβολῇ
υπομονην: ὑπομονήν, ὑπομονὴν
υστερημα: ὑστέρημά, ὑστέρημα
φοβηθητε: φοβήθητε, φοβηθῆτε
φωτεινον: φωτεινόν, φωτεινὸν
χειλεσιν: χείλεσίν, χείλεσιν
χειμωνος: χειμῶνος, χειμῶνός
ωφελιμος: ὠφέλιμος, ὠφέλιμός
Ασπαζεται: Ἀσπάζεταί, Ἀσπάζεται
Γαλιλαιος: Γαλιλαῖος, Γαλιλαῖός
Ελληνιστι: Ἑλληνιστί, Ἑλληνιστὶ
Μαγδαληνη: Μαγδαληνή, Μαγδαληνὴ, Μαγδαληνῇ
Φαρισαιος: Φαρισαῖος, Φαρισαῖός
αγαθωσυνη: ἀγαθωσύνη, ἀγαθωσύνῃ
ακαθαρσια: ἀκαθαρσία, ἀκαθαρσίᾳ
ακολουθει: ἀκολουθεῖ, ἀκολούθει
ακουοντας: ἀκούοντάς, ἀκούοντας
αμαρτωλοι: ἁμαρτωλοί, ἁμαρτωλοὶ
αμαρτωλος: ἁμαρτωλός, ἁμαρτωλὸς
ανεβλεψεν: ἀνέβλεψέν, ἀνέβλεψεν
αποκειται: ἀπόκειταί, ἀπόκειται
αρχιερευς: ἀρχιερεύς, ἀρχιερεὺς
αρχιερεων: ἀρχιερέων, ἀῥχιερέων
βαπτιστης: βαπτιστής, βαπτιστὴς
βασιλικος: βασιλικός, βασιλικὸς
βουλευτης: βουλευτής, βουλευτὴς
δυνησεται: δυνήσεταί, δυνήσεται
εγερθηναι: ἐγερθῆναί, ἐγερθῆναι
εγκρατεια: ἐγκράτεια, ἐγκρατείᾳ
εκελευσεν: ἐκέλευσέν, ἐκέλευσεν
εκλεκτους: ἐκλεκτούς, ἐκλεκτοὺς
ελαχιστον: ἐλάχιστον, ἐλάχιστόν
ελευθερια: ἐλευθερία, ἐλευθερίᾳ
ελευθεροι: ἐλεύθεροί, ἐλεύθεροι
εμπροσθεν: ἔμπροσθέν, ἔμπροσθεν
επαγγελια: ἐπαγγελία, ἐπαγγελίᾳ
επεχρισεν: ἐπέχρισέν, ἐπέχρισεν
επιθεσεως: ἐπιθέσεως, ἐπιθέσεώς
επιστολην: ἐπιστολήν, ἐπιστολὴν
ετολμησεν: ἐτόλμησέν, ἐτόλμησεν
ευαρεστον: εὐάρεστον, εὐάρεστόν
ευλογειτε: εὐλογειτε, εὐλογεῖτε
ζητουντες: ζητοῦντές, ζητοῦντες
ηπιστησαν: ἠπίστησάν, ἠπίστησαν
θαυμαστον: θαυμαστόν, θαυμαστὸν
θυγατριον: θυγάτριον, θυγάτριόν
καλουμενη: καλουμένη, καλουμένῃ
κατηγοροι: κατήγοροί, κατήγοροι
κραβαττον: κράβαττον, κράβαττόν
κρινεσθαι: κρίνεσθαί, κρίνεσθαι
λαλουντος: λαλοῦντος, λαλοῦντός
λαμβανετε: λαμβάνετέ, λαμβάνετε
λιβανωτον: λιβανωτόν, λιβανωτὸν
μετανοιαν: μετάνοιάν, μετάνοιαν
μονογενης: μονογενής, μονογενὴς
οικοδομας: οἰκοδομάς, οἰκοδομὰς
οικοδομων: οἰκοδομῶν, οἰκοδόμων
οικουμενη: οἰκουμένη, οἰκουμένῃ
οικτιρμων: οἰκτίρμων, οἰκτιρμῶν
οφθαλμους: ὀφθαλμούς, ὀφθαλμοὺς
παραβολας: παραβολάς, παραβολὰς
παραβολην: παραβολήν, παραβολὴν
παρακαλει: παρακάλει, παρακαλεῖ
παρασκευη: παρασκευή, παρασκευὴ
παρεδωκαν: παρέδωκάν, παρέδωκαν
πειρασμον: πειρασμόν, πειρασμὸν
πεμψαντος: πέμψαντος, πέμψαντός
περιπατει: περιπάτει, περιπατεῖ
περιτομην: περιτομήν, περιτομὴν
πιστευετε: πιστεύετέ, πιστεύετε
πλεονεξια: πλεονεξία, πλεονεξίᾳ
πνευματος: πνεύματος, πνεύματός
προσευχαι: προσευχαί, προσευχαὶ
προσευχας: προσευχάς, προσευχὰς
προσηλθαν: προσῆλθάν, προσῆλθαν
προσφορας: προσφοράς, προσφορὰς, προσφορᾶς
προφητεια: προφητεία, προφητείᾳ
σκοτεινον: σκοτεινόν, σκοτεινὸν
σταυρωσαι: σταυρῶσαί, σταυρῶσαι
συναγωγας: συναγωγάς, συναγωγὰς
συναγωγην: συναγωγήν, συναγωγὴν
συνδουλος: σύνδουλος, σύνδουλός
συνεταξεν: συνέταξέν, συνέταξεν
συντελεια: συντέλεια, συντελείᾳ
ταπεινους: ταπεινούς, ταπεινοὺς
υπαρχοντα: ὑπάρχοντά, ὑπάρχοντα
υποκριται: ὑποκριταί, ὑποκριταὶ
υποποδιον: ὑποπόδιον, ὑποπόδιόν
φαρμακεια: φαρμακεία, φαρμακείᾳ
χιλιαρχος: χιλίαρχος, χιλιαρχος
ψευσασθαι: ψεύσασθαί, ψεύσασθαι
Γεννησαρετ: Γεννησαρέτ, Γεννησαρὲτ
Ιερουσαλημ: Ἰερουσαλήμ, Ἰερουσαλὴμ
Ισραηλιται: Ἰσραηλῖταί, Ἰσραηλῖται
Καφαρναουμ: Καφαρναούμ, Καφαρναοὺμ
Μελχισεδεκ: Μελχισεδέκ, Μελχισεδὲκ
ακροβυστια: ἀκροβυστία, ἀκροβυστίᾳ
αμαρτωλους: ἁμαρτωλούς, ἁμαρτωλοὺς
αναστροφην: ἀναστροφήν, ἀναστροφὴν
απαγγειλαι: ἀπαγγεῖλαί, ἀπαγγεῖλαι
απεκαλυψεν: ἀπεκάλυψέν, ἀπεκάλυψεν
απεσταλκεν: ἀπέσταλκέν, ἀπέσταλκεν
απεστειλεν: ἀπέστειλέν, ἀπέστειλεν
αποκριθητε: ἀποκρίθητέ, ἀποκριθῆτε
ασπαζονται: ἀσπάζονταί, ἀσπάζονται
αφεθησεται: ἀφεθήσεταί, ἀφεθήσεται
βουλομενος: βουλόμενος, βουλόμενός
διδασκαλια: διδασκαλία, διδασκαλίᾳ
δικαιοσυνη: δικαιοσύνη, δικαιοσύνῃ
δικαιωματα: δικαιώματά, δικαιώματα
εγενηθησαν: ἐγενήθησάν, ἐγενήθησαν
επαισχυνθη: ἐπαισχυνθῇ, ἐπαισχύνθη
επηρωτησεν: ἐπηρώτησέν, ἐπηρώτησεν
επιδειξατε: ἐπιδείξατέ, ἐπιδείξατε
ευαγγελιον: εὐαγγέλιον, εὐαγγέλιόν
ευχαριστια: εὐχαριστία, εὐχαριστίᾳ
ηνεωχθησαν: ἠνεῴχθησάν, ἠνεῴχθησαν
καταπαυσιν: κατάπαυσίν, κατάπαυσιν
κατευθυναι: κατευθύναι, κατευθῦναι
κεχαρισται: κεχάρισταί, κεχάρισται
κληθησεται: κληθήσεταί, κληθήσεται
κολυμβηθρα: κολυμβήθρα, κολυμβήθρᾳ
κρειττονος: κρείττονος, κρείττονός
μακροθυμια: μακροθυμία, μακροθυμίᾳ
παραδιδους: παραδιδούς, παραδιδοὺς
παρασκευην: παρασκευήν, παρασκευὴν
παρεκαλεσα: παρεκάλεσά, παρεκάλεσα
παρεμβολην: παρεμβολήν, παρεμβολὴν
περιστερας: περιστεράς, περιστερὰς
πνευματικα: πνευματικά, πνευματικὰ
συμβουλιον: συμβούλιον, συμβούλιόν
φιλαδελφια: φιλαδελφία, φιλαδελφίᾳ
φοβουμενοι: φοβούμενοί, φοβούμενοι
ανεκτοτερον: ἀνεκτοτερον, ἀνεκτότερον
απαγγειλατε: ἀπαγγείλατέ, ἀπαγγείλατε
απειθησασιν: ἀπειθήσασίν, ἀπειθήσασιν
διαλογισμοι: διαλογισμοί, διαλογισμοὶ
εγκατελιπες: ἐγκατέλιπές, ἐγκατέλιπες
ειδωλοθυτον: εἰδωλόθυτον, εἰδωλόθυτόν
επεγινωσκον: ἐπεγίνωσκον, ἐπεγίνωσκόν
ετοιμασωμεν: ἑτοιμάσωμέν, ἑτοιμάσωμεν
ευκοπωτερον: εὐκοπώτερον, εὐκοπώτερόν
ισχυροτερος: ἰσχυρότερος, ἰσχυρότερός
λαληθησεται: λαληθήσεταί, λαληθήσεται
μνημονευετε: μνημονεύετέ, μνημονεύετε
παραλυτικος: παραλυτικός, παραλυτικὸς
παρατιθεμαι: παρατίθεμαί, παρατίθεμαι
παρεκαλεσεν: παρεκάλεσέν, παρεκάλεσεν
περισσευσαι: περισσεύσαι, περισσεῦσαι
πιστευσωμεν: πιστεύσωμέν, πιστεύσωμεν
πνευματικον: πνευματικόν, πνευματικὸν
πνευματικος: πνευματικός, πνευματικὸς
ακολουθουσιν: ἀκολουθοῦσίν, ἀκολουθοῦσιν
ανεστραφημεν: ἀνεστράφημέν, ἀνεστράφημεν
ανταποδουναι: ἀνταποδοῦναί, ἀνταποδοῦναι
δαιμονισθεις: δαιμονισθείς, δαιμονισθεὶς
εκπορευομενα: ἐκπορευόμενά, ἐκπορευόμενα
κατηγορουσιν: κατηγοροῦσίν, κατηγοροῦσιν
λατρευσουσιν: λατρεύσουσίν, λατρεύσουσιν
περισσοτερον: περισσότερον, περισσότερόν
απεσταλμενους: ἀπεσταλμένους, ἀπεσταλμενοῦς
ευχαριστουμεν: εὐχαριστοῦμέν, εὐχαριστοῦμεν
μαρτυρουμενος: μαρτυρούμενος, μαρτυρούμενός
παραγενομενος: παραγενόμενος, παραγενόμενός
περιεπατησατε: περιεπατήσατέ, περιεπατήσατε
ευαγγελισασθαι: εὐαγγελίσασθαί, εὐαγγελίσασθαι
προσκαλεσαμενος: προσκαλεσάμενος, προσκαλεσάμενός
μη 
                      : μή ͜
                      , μὴ ͜
                      
